        1111111111111111111111111
        10000000001100000000000011111
        10110S00011100000100000000001
        10110000011100000100000010001
        1011000001110000010000001
        1011000001110000010000001
        1011000001110000010000001
        1011000001110000010000001
        1111111111111111111111111


        ////////////////////////////////////////////////
        