F 100,100,100
C 153,255,255


NO ./textures/NO.xpm
SO ./textures/SO.xpm
WE ./textures/WE.xpm
EA ./textures/EA.xpm
 
           11111111  
            10N0001    
            1000001   
           10000011       
            11111111   