C 153,255,255
F 100,100,100


NO ./textures/NO.xpm
SO ./textures/SO.xpm
WE ./textures/WE.xpm
EA ./textures/EA.xpm

        11111
        100S011
        10001
        11111