C 153,255,255
F 100,100,100
NO ./game_assets/NO.xpm
SO ./game_assets/SO.xpm
WE ./game_assets/WE.xpm
EA ./game_assets/EA.xpm

        1111111111111111111111111
        10000S0000110000000000001
        1011000001110000010000001
        1011000001110000010000001
        1011000001110000010000001
        1011000001110000010000001
        1011000001110000010000001
        1011000001110000010000001
        1111111111111111111101111


