
NO ./textures/texture_heart.xpm
SO ./textures/texture_heart.xpm
WE ./textures/texture_heart.xpm
EA ./textures/texture_heart.xpm



F 225,104,143
C 101,101,101



    111111111111111111111111
    110000000011000000000001
    101100000111000000W00101
    100100000000000000000001
1111111110110000011100000001 
1000000000110000011101111111
1111011111111101110000001001
1111011111111101110101001001
1100000011010101110000001001
1000000000000000110000001001
1000000000000000110101001001
1100000111010111111011110001
11111111 111011 101111010001
11111111 111111 111111111111

